DON  1000
KA   1500
DON  2000
DON  2500
KA   3000
DON  3500
DON  3750
DON  4000